R 900 720
NO ./textures/gray_terracotta.xpm
SO ./textures/sandstone.xpm
WE ./textures/red_sandstone.xpm
EA ./textures/bricks.xpm
S  ./textures/barrel.xpm
F 115,115,115
C 217,250,252


      11111111111111111111111111111
        10200000000000020000000000011
         11000000020000000000001110001
        10000000000000S00000101000111  111
         11111110000000000001000000011100011
                110000000000000020000000000011
111111111 1111111111000200000000000000220000001
10000000010000000002200000011111111111111111111
1111111111111011111111111111
1111111111111011111111111111
1000000000000000000000000001
100000000000000000000000000111111111
1000000222222111111111222222222200001
10000000000001      1000000000000001
10000000000000111111100000011111111
1000000000000000000000000001
1000000000000000000000000001      
1111111111111011111111111111 1111111
1111111101111000000000011111
1111111101111111111111011111
11111100000000000000001111
11111111011111111111111111111
1111111100000000000001111111
1111111111111111111100000211
1111 11111 111111111111111111