R 900 720
NO ./textures/gray_terracotta.xpm
SO ./textures/sandstone.xpm
WE ./textures/red_sandstone.xpm
EA ./textures/bricks.xpm
S ./textures/barrel.xpm
F 115,115,115
C 217,250,252

1111111111111111111111111111
1020000000000002000000000001
1000000000000000000001110001
1000000E00000000000001010001
1000000000000100000001110001
1000000000000000000000000001
1000200000000000000220000001
1000000001000000000220000001
1111111111111011111111111111
1111111111111011111111111111
1000000000000000000000000001
1000000000000000000000000001
1000000222222222222222220001
1000000000000000000000000001
1000000000000000000000000001
1000000000000000000000000001
1000000000000000000000000001
1111111111111011111111111111
1111111101111000000000011111
1111111101111111111111011111
1111111100000000000000001111
1111111101111111111111111111
1111111100000000000001111111
1111111111111111111100000211
1111111111111111111111111111
